1220,1219,1218,1217,1216,1215,1214,1213,1212,1211,1210
1199,1200,1201,1202,1203,1204,1205,1206,1207,1208,1209
1198,1197,1196,1195,1194,1193,1192,1191,1190,1189,1188
1177,1178,1179,1180,1181,1182,1183,1184,1185,1186,1187
1176,1175,1174,1173,1172,1171,1170,1169,1168,1167,1166
1155,1156,1157,1158,1159,1160,1161,1162,1163,1164,1165
1154,1153,1152,1151,1150,1149,1148,1147,1146,1145,1144
1133,1134,1135,1136,1137,1138,1139,1140,1141,1142,1143
1132,1131,1130,1129,1128,1127,1126,1125,1124,1123,1122
1111,1112,1113,1114,1115,1116,1117,1118,1119,1120,1121
1110,1109,1108,1107,1106,1105,1104,1103,1102,1101,1100
1089,1090,1091,1092,1093,1094,1095,1096,1097,1098,1099
1088,1087,1086,1085,1084,1083,1082,1081,1080,1079,1078
1067,1068,1069,1070,1071,1072,1073,1074,1075,1076,1077
1066,1065,1064,1063,1062,1061,1060,1059,1058,1057,1056
1045,1046,1047,1048,1049,1050,1051,1052,1053,1054,1055
1044,1043,1042,1041,1040,1039,1038,1037,1036,1035,1034
1023,1024,1025,1026,1027,1028,1029,1030,1031,1032,1033
1022,1021,1020,1019,1018,1017,1016,1015,1014,1013,1012
1001,1002,1003,1004,1005,1006,1007,1008,1009,1010,1011
